scottish = scottish
wals = wals
mazurka = mazurka
wals in 5 = wals in 5
wals in 8 = wals in 8
wals in 11 = wals in 11
tovercirkel = tovercirkel
jigs = jigs = french
jig = jigs = french
tarantella = tarantella
kost ar c'hoad = kost ar oat
misirlou = misirloe
fandango = fandango
fandango - arin-arin = fandango
bourrée in 2 = boerree in 2
bourrée in 3 = boerree in 3
repasseado = repasseado
andro = andro
hanterdro = hanterdro
gavottes suite = gavvotte swiet
gavotte = gavvotte
gavotte des montagnes = gavotte des montagnes = french
suite gavottes des montagnes = suite gavottes des montagnes = french
polka = polka
gavotte de l'aven = gavotte de l'aven = french
maraichines = marachien
maraîchines = marachien
marchoise = marchwaaz
madison = madison
pas d'été = pa d'été
pas d'été du pingouin ivre = pa d'été du penguai ievre
plinn = plinn
plinn suite = plinn swiet
suite plinn bal = swiet plinn bal
suite plinn dans = swiet plinn dans
suite plinn = swiet plinn
polska = polska
polka = polka
reels = riels
ridée = ridé
laridé = laridé = french
ronde de saint-vincent = rond de saint vincent = french
rond de saint-vincent = rond de saint vincent = french
rondeau = rondeau
rondeau en chaine = rondeau en chène
rondeau en chaîne = rondeau en chène
rondeau en couple = rondeau en coeple
scottish impaire = scottish impair
suite de bransles = swiete de branle
branle de noirmoutier = branle de noirmoutier = french
tricot = triko
la poraie = la poraie = french
poraie = poraie = french
polaïe = poraie = french
bal limousine = bal limousien
avant-deux = avant deu
avant-deux cercle = avant deu serkle
avant-deux de gatine = avant deu de gatien
avant-deux à coutant = avant deu a koutant
kas abarh = kasabba
carnaval de lantz = carnaval de lantz
chula picada = chula picada
drumul dracului = drumul draculi
erva cidreira = erva cidreira
fado batido = fado batido
mardi gras = mardi gra
mazurka - wals = mazurka - wals
ronde de loudéac = ronde de loedéac
rond de loudéac = ronde de loedéac
suite de loudéac = swiete de loedéac
rondes du quercy = ronde du kercy
ronde du quercy = ronde du kercy
scottish - polka = scottish - polka
tovercirkel - wals - tovercirkel = tovercirkel - wals - tovercirkel
wals - scottish = wals - scottish
wals écossaise = wals écossèse
suite de loudéac = swiete de loedéac
rond d'argenton = rond d'argenton = french
bransle de vallée d'ossau = bransle de vallée d'ossau = french
saia de carlonina = saia de carlonaina
regadinho = regadino
fadino de lavos = fadino de lavos
rondeau en couple - tovercirkel = rondeau en coeple - tovercirkel
mazurka créole = mazurka creeol
bransles dossau = branle dossau
branles d'ossau = branle dossau
traditionele mazurka = traditionele mazurka
rond d'argenton = rond d'argenton = french
slow = slow
saia de carolina = saaja de karolaina
congo de captieux = kongo de kaptjeu
bransles dossau = branle dossoo
rond de barbatre = ron de barbatre
la poraïe = la porraje
rond de marguerite = rond de margurite
rond de l'île d'yeu = rond de lil djeu
bransle de l'épine = branle de lepien
ronde de chantecorps = rond de shantekor
branle biarnés = branle bearnè
tango = tango
branle de noirmoutier = branle de noirmoutier = french
saut béarnais = saut béarnais = french
set de saut béarnais = set de saut béarnais = french
pas d'été a 4 = pas d'été a quatre = french
demi rond = demi rond = french
avant deux à coutant = avant deux à coutant = french
ronde d'avant-deux = ronde d'avant-deux = french
avant deux de gatine = avant deux de gatine = french
fadinho de lavos = fadinho de lavos = french
Fado Batido = Fado Batido = french
Erva Cidreira = Erva Cidreira = french
Drumul Dracului = Drumul Dracului = french
Regadinho = Regadinho = french
Chula Picada = Chula Picada = french
saia da carolina = saia da carolina = french
toma-lá-dá-cá = toma-lá-dá-cá = french
branle de la fosse aux loups = branle de la fosse aux loups = french
contradans = contradans
lange nelle = lange nelle
halling = halling
rigodon = rigodon = french
wals in 92 = wals in 92
rond de barbâtre = rond de barbatre = french
danse des ours = danse des ours = french
ronde = ronde = french
slängpolska = slengpolska
wals musette = wals
tovercirkel in 3 = tovercikel in 3